...v<<<.......................
..#v##^.......................
.##v##^.......................
.#.>>>^.......................
.##.##X.......................
.##.##^.......................
.S#.##^##.....................
.##.T###......................
..............................

Legend
. MapWater
# MapGrass
^ MapWaterCurrentUp
v MapWaterCurrentDown
> MapWaterCurrentRight
< MapWaterCurrentLeft
T MapScenery('fir-tree')
S MapSpawnPoint
X MapBlockage
